['X', 'X', 'X', 'X', 'X', 'X', 'X', 'X', 'X', 'X', 'X', 'X']
['X', 'X', 'X', 'M', 'X', 'X', 'X', 'X', 'X', 'G', 'X', 'X']
['X', 'D', ' ', ' ', ' ', 'X', 'X', ' ', ' ', ' ', 'W', 'X']
['X', 'X', ' ', ' ', ' ', 'X', ' ', ' ', ' ', ' ', 'X', 'X']
['X', 'O', ' ', ' ', ' ', 'X', 'B', ' ', ' ', ' ', 'X', 'X']
['X', 'X', ' ', ' ', ' ', ' ', 'X', ' ', ' ', ' ', 'X', 'X']
['X', 'X', ' ', ' ', ' ', 'X', 'X', ' ', ' ', ' ', 'X', 'X']
['X', 'X', ' ', ' ', ' ', 'X', 'X', ' ', ' ', ' ', 'X', 'X']
['X', 'X', ' ', ' ', ' ', ' ', ' ', ' ', ' ', ' ', 'X', 'X']
['X', 'X', 'X', 'X', 'S', 'X', 'X', 'S', 'X', 'X', 'X', 'X']